0200000000000000000000000
0111111101111101111101010
0001010000010101000101010
0101010111010114110111110
0100010500010001000000010
0111111101011101011111110
0100010001000001000100010
0111011111010101010111010
0001010001010101010000050
0111010111010111011111010
0100000000010100000001010
0111110111151101011101110
0101000101010001000101000
0501011101010111110101110
0001000000010100010101010
0111011111011111050111010
0100010001000000010000010
0114110111011101111101110
0000000001010000010000010
0111110111110101110111010
0100010500000101000001010
0111011101410101110111110
0001000001010101000101010
0111111111011111110101010
0000000000000000000000030

