0200000000000000000000000
0111111111111115011111110
0000000000010000010000010
0111111111011111011111010
0101000101000001000001010
0101011101150101111114010
0100010000000100010101010
0111011111110111110101010
0100000100010000010001010
0111011111011111010111010
0004000100010001000100010
0111110101110111110101110
0100000000000001000001000
0111111101011101111111150
0100010001010000000000000
0501110111111501011111110
0001000100010001010001010
0111011111010111011101010
0001010001000100000100010
0111011101110111010101110
0100000100010001010101000
0111011101110101110101110
0101010004000101000100010
0101110111111111111101110
0000000000000000000000030

