0200000000000000000000000
0111011111011111110101110
0100010101010000010101010
0101010101011101111111010
0101010101010000000001010
0111110101110111011101010
0101000000000100010100010
0101015111111101110111010
0000000001000100010000010
0111110101110111014111110
0000010100010001010000010
0111111101110101111101150
0100010001000100000000000
0111011111010111011111050
0001000000010101010101010
0111011511011101010101110
0100010000010101010001010
0101410101110101010101010
0101010101000001010100010
0111010101015114011111010
0001010101010001010101010
0111010101011101010101010
0101010101010001000001010
0101011111011101111111010
0000000000000000000000030

