0200000000000000000000000
0101110101011111010111110
0101010101010000010101000
0111010111115101011101110
0100010001010001010001010
0101111111011101110101010
0000000001000001000100010
0101110111010111011114110
0101010100010100000001000
0111011101110111010101110
0000010000010100010101000
0101111114110111015101110
0500000001010001010100010
0111111111010111110101110
0100000000010000010100010
0101111101010111110101110
0100010001000100000001000
0111011111110111050111110
0001000100000001010000010
0111111101011111011111010
0100000001010000010101010
0111110501410111010101110
0001000101010100010000000
0111111111011101111111110
0000000000000000000000030

